nyy	NY Yankees
bos	Boston
nym	New York Mets
ana	LA Angels
cws	Chi White Sox
la	LA Dodgers
sea	Seattle
chc	Chi Cubs
det	Detroit
bal	Baltimore
stl	St. Louis
sf	San Francisco
phi	Philadelphia
hou	Houston
atl	Atlanta
tor	Toronto
oak	Oakland
min	Minnesota
mil	Milwaukee
cin	Cincinnati
tex	Texas
kc	Kansas City
cle	Cleveland
sd	San Diego
col	Colorado
ari	Arizona
pit	Pittsburgh
was	Washington
fla	Florida
tb	Tampa Bay